                                                            f
                $$$                                         f
                $$$                                         f
                ___                                         f
          $$$$           $$                                 f
          ____           __                                 f
     $$                                                     f
    ____                                            _____   f
                                        b                   f
        ss  ss  t     tssssssss         p   ss  ss  ssssssssf
ggggggggggggggggggggggggggggggggggggggggggggggggggggggggggggggggggggggggggggg
ddddddddddddddddddddddddddddddddddddddddddddddddddddddddddddddddddddddddddddd