                                                                                                                  f
                $$$                                                                                               f
                $$$                                                                                    $          f
                ___                                                                         $   $$      $$$       f
          $$$$           $$                                                      $$$               $$         $   f
          ____           __                                              $$     _____     $    $$      $$$        f
     $$                                              $$$       $$$$     _____                               $$    f
    ____                                            _____     _______                              $              f
                                        b                                              b     $                    f
        ss  ss  t     tssssssss         p   ss  ss  ssssssss  s s s s s s s s s s s s  p  t s t s t t s s t s t s f
ggggggggggggggggggggggggggggggggggggggggggggggggggggggggggggggggggggggggggggggggggggggggggggggggggggggggggggggggggggggggggggggggggggggggggg
ddddddddddddddddddddddddddddddddddddddddddddddddddddddddddddddddddddddddddddddddddddddddddddddddddddddddddddddddddddddddddddddddddddddddddd