                                                            f
                $$$$                                        f
                $$$$                                        f
                ____          _____                         f
          $$$$     q                                        f
          ____     q   ____                                 f
    $ $            q                                        f
    ____           q                                        f
    q              q                    b                   f
    q   ss  ss  t  q  tssssssssss       p                   f
gggggggggggggggggggggggggggggggggggggggggggggggggggggggggggggggggggggggggggg
dddddddddddddddddddddddddddddddddddddddddddddddddddddddddddddddddddddddddddd